##############
#            #
# ######*### #
# #        # #
# #        # #
#    ####  # #
# #  #  #  # #
# #  #  #  # #
# # #   #  # #
# # #####    #
# #  . . . # #
# #  $@$ $ # #
# ###*###### #
#            #
##############